A	AH
A(2)	EY
BROWSER	B R AW Z ER
CALENDAR	K AE L AH N D ER
E-MAIL	IY M EY L
EIGHT	EY T
FIVE	F AY V
FOUR	F AO R
MAPS	M AE P S
MUSIC	M Y UW Z IH K
NEW	N UW
NEW(2)	N Y UW
NINE	N AY N
NOTE	N OW T
ONE	W AH N
ONE(2)	HH W AH N
OPEN	OW P AH N
PICTURE	P IH K CH ER
PLAYER	P L EY ER
SEARCH	S ER CH
SEVEN	S EH V AH N
SIX	S IH K S
TAKE	T EY K
THREE	TH R IY
TWO	T UW
